####################################################################################################
#A                                                                                                 #
#################################################################################################  #
#                                                                                                  #
#  #################################################################################################
#                                                                                                  #
#################################################################################################  #
#                                                                                                  #
#  #################################################################################################
#                                                                                                  #
#################################################################################################  #
#                                                                                                  #
#  #################################################################################################
#                                                                                                  #
#################################################################################################  #
#                                                                                                  #
#  #################################################################################################
#  #################################################################################################
#                                                                                                  #
#################################################################################################  #
#                                                                                                  #
#  #################################################################################################
#                                                                                                  #
#################################################################################################  #
#                                                                                                  #
#  #################################################################################################
#                                                                                                  #
#################################################################################################  #
#                                                                                                  #
#  #################################################################################################
#  #################################################################################################
#                                                                                                  #
#################################################################################################  #
#                                                                                                  #
#  #################################################################################################
#                                                                                                  #
#################################################################################################  #
#                                                                                                  #
#  #################################################################################################
#                                                                                                  #
#################################################################################################  #
#                                                                                                  #
#  #################################################################################################
#  #################################################################################################
#                                                                                                  #
#################################################################################################  #
#                                                                                                  #
#  #################################################################################################
#                                                                                                  #
#################################################################################################  #
#                                                                                                  #
#  #################################################################################################
#                                                                                                  #
#################################################################################################  #
#                                                                                                  #
#  #################################################################################################
#  #################################################################################################
#                                                                                                  #
#################################################################################################  #
#                                                                                                  #
#  #################################################################################################
#                                                                                                  #
#################################################################################################  #
#                                                                                                  #
#  #################################################################################################
#                                                                                                  #
#################################################################################################  #
#                                                                                                  #
#  #################################################################################################
#  #################################################################################################
#                                                                                                  #
#################################################################################################  #
#                                                                                                  #
#  #################################################################################################
#                                                                                                  #
#################################################################################################  #
#                                                                                                  #
#  #################################################################################################
#                                                                                                  #
#################################################################################################  #
#                                                                                                  #
#  #################################################################################################
#  #################################################################################################
#                                                                                                  #
#################################################################################################  #
#                                                                                                  #
#  #################################################################################################
#                                                                                                  #
#################################################################################################  #
#                                                                                                  #
#  #################################################################################################
#                                                                                                  #
#################################################################################################  #
#                                                                                                  #
#  #################################################################################################
#  #################################################################################################
#                                                                                                  #
#################################################################################################  #
# B                                                                                                #
####################################################################################################