##############################
#A.......................... #
###########################. #
#........................... #
#.############################
#..........................  #
##########################.######################
#                         ..............        #
#######################################.        ###########
#                                      ..............     #
####################################################.     ######
#                                                  #..         #
#                                                  ##......    #
##                                                  ######.   #
##                                                  #    ..###
##                                                  ##  ..#
##                                                  #   .#
##                                                  #  ..#
##                                                  # ..#
##                                                  #..#
###################################  ############### .###
#                     #############      ##########  .#
#                   #.................................#
#####################.#################################
#                    .#   #
#                  ...#   #
###################.###    #
# B.................      #
#################        #####
##############################
