##############################
#A                           #
###########################  #
#                            #
# ############################
#                            #
########################## ######################
#                                               #
#######################################         ###########
#                                                         #
####################################################      ######
#                                                  #           #
#                                                  ##          #
##                                                  ######    #
##                                                  #      ###
##                                                  ##    #
##                                                  #    #
##                                                  #    #
##                                                  #   #
##                                                  #  #
###################################  ###############  ###
#                     #############      ##########   #
#                   #                                 #
##################### #################################
#                     #   #
#                     #   #
################### ###    #
# B                       #
#################        #####
##############################
