##############
#   #   #    #
# A #  ##### #
#      #  ## #
######### #  #
#        B# ##
# ######  #  #
#   #  # ### #
#   #        #
##############
