##############
#   #........#
# A #. #####.#
# .... #  ##.#
######### #..#
#        B#.##
# ######..#..#
#   #  #.###.#
#   #   .....#
##############
