##############
#   #        #
# A #  ##### #
#      #  ## #
######### #  #
#        B# ##
# ######  #  #
#   #  # ### #
#   #     A  #
##############
