####################################################################################################
#A................................................................................................ #
#################################################################################################. #
# ................................................................................................ #
# .#################################################################################################
# ................................................................................................ #
#################################################################################################. #
# ................................................................................................ #
# .#################################################################################################
# ................................................................................................ #
#################################################################################################. #
# ................................................................................................ #
# .#################################################################################################
# ................................................................................................ #
#################################################################################################. #
# ................................................................................................ #
# .#################################################################################################
# .#################################################################################################
# ................................................................................................ #
#################################################################################################. #
# ................................................................................................ #
# .#################################################################################################
# ................................................................................................ #
#################################################################################################. #
# ................................................................................................ #
# .#################################################################################################
# ................................................................................................ #
#################################################################################################. #
# ................................................................................................ #
# .#################################################################################################
# .#################################################################################################
# ................................................................................................ #
#################################################################################################. #
# ................................................................................................ #
# .#################################################################################################
# ................................................................................................ #
#################################################################################################. #
# ................................................................................................ #
# .#################################################################################################
# ................................................................................................ #
#################################################################################################. #
# ................................................................................................ #
# .#################################################################################################
# .#################################################################################################
# ................................................................................................ #
#################################################################################################. #
# ................................................................................................ #
# .#################################################################################################
# ................................................................................................ #
#################################################################################################. #
# ................................................................................................ #
# .#################################################################################################
# ................................................................................................ #
#################################################################################################. #
# ................................................................................................ #
# .#################################################################################################
# .#################################################################################################
# ................................................................................................ #
#################################################################################################. #
# ................................................................................................ #
# .#################################################################################################
# ................................................................................................ #
#################################################################################################. #
# ................................................................................................ #
# .#################################################################################################
# ................................................................................................ #
#################################################################################################. #
# ................................................................................................ #
# .#################################################################################################
# .#################################################################################################
# ................................................................................................ #
#################################################################################################. #
# ................................................................................................ #
# .#################################################################################################
# ................................................................................................ #
#################################################################################################. #
# ................................................................................................ #
# .#################################################################################################
# ................................................................................................ #
#################################################################################################. #
# ................................................................................................ #
# .#################################################################################################
# .#################################################################################################
# ................................................................................................ #
#################################################################################################. #
# ................................................................................................ #
# .#################################################################################################
# ................................................................................................ #
#################################################################################################. #
# ................................................................................................ #
# .#################################################################################################
# ................................................................................................ #
#################################################################################################. #
# ................................................................................................ #
# .#################################################################################################
# .#################################################################################################
# ................................................................................................ #
#################################################################################################. #
# B............................................................................................... #
####################################################################################################
